REM	REM	.	1
DATA	DATA	D.	1
INPUT	INPUT	I.	1
COLOR	COLOR	C.	1
LIST	LIST	L.	1
ENTER	ENTER	E.	1
LET	LET	LE.	1
IF	IF	IF	1
FOR	FOR	F.	1
NEXT	NEXT	N.	1
GOTO	GOTO	G.	1
GO_TO	GO TO	G.	1
GOSUB	GOSUB	GOS.	1
TRAP	TRAP	T.	1
BYE	BYE	B.	1
CONT	CONT	CON.	1
COM	COM	COM	1
CLOSE	CLOSE	CL.	1
CLR	CLR	CLR	1
DEG	DEG	DE.	1
DIM	DIM	DI.	1
END	END	END	1
NEW	NEW	NEW	1
OPEN	OPEN	O.	1
LOAD	LOAD	LO.	1
SAVE	SAVE	S.	1
STATUS	STATUS	ST.	1
NOTE	NOTE	NO.	1
POINT	POINT	P.	1
XIO	XIO	X.	1
ON	ON	ON	1
POKE	POKE	POK.	1
PRINT	PRINT	PR.	1
RAD	RAD	RA.	1
READ	READ	REA.	1
RESTORE	RESTORE	RES.	1
RETURN	RETURN	RET.	1
RUN	RUN	RU.	1
STOP	STOP	STO.	1
POP	POP	POP	1
PRINT_	?	?	1
GET	GET	GE.	1
PUT	PUT	PU.	1
GRAPHICS	GRAPHICS	GR.	1
PLOT	PLOT	PL.	1
POSITION	POSITION	POS.	1
DOS	DOS	DO.	1
DRAWTO	DRAWTO	DR.	1
SETCOLOR	SETCOLOR	SE.	1
LOCATE	LOCATE	LOC.	1
SOUND	SOUND	SO.	1
LPRINT	LPRINT	LP.	1
CSAVE	CSAVE	CS.	1
CLOAD	CLOAD	CLOA.	1
LET_INV			0
BAS_ERROR	ERROR -	ERROR -	1
DPOKE	DPOKE	DP.	2
MOVE	MOVE	M.	2
N_MOVE	-MOVE	-.	2
F_F	*F	*.	2
REPEAT	REPEAT	REP.	2
UNTIL	UNTIL	U.	2
WHILE	WHILE	W.	2
WEND	WEND	WE.	2
ELSE	ELSE	EL.	2
ENDIF	ENDIF	END.	2
BPUT	BPUT	BP.	2
BGET	BGET	BG.	2
FILLTO	FILLTO	FI.	2
DO	DO	DO	2
LOOP	LOOP	LOO.	2
EXIT	EXIT	EX.	2
DIR	DIR	DIR	2
LOCK	LOCK	LOCK	2
UNLOCK	UNLOCK	UNL.	2
RENAME	RENAME	REN.	2
DELETE	DELETE	DEL.	2
PAUSE	PAUSE	PA.	2
TIME_S	TIME$=	TI.	2
PROC	PROC	PRO.	2
EXEC	EXEC	EXE.	2
ENDPROC	ENDPROC	ENDP.	2
FCOLOR	FCOLOR	FC.	2
F_L	*L	*L	2
REM_	--	--	1
RENUM	RENUM	RENU.	2
DEL	DEL	DEL	2
DUMP	DUMP	DU.	2
TRACE	TRACE	TRAC.	2
TEXT	TEXT	TE.	2
BLOAD	BLOAD	BL.	2
BRUN	BRUN	BR.	2
GO_S	GO#	GO#	2
LBL_S	#	#	2
F_B	*B	*B	2
PAINT	PAINT	PAI.	2
CLS	CLS	CLS	2
DSOUND	DSOUND	DS.	2
CIRCLE	CIRCLE	CI.	2
P_PUT	%PUT	%.	2
P_GET	%GET	%G.	2
ENDIF_INVISIBLE			0
IF_MULTILINE	IF	IF	0
IF_THEN	IF	IF	0
IF_NUMBER	IF	IF	0
PROC_VAR	PROC		0
EXEC_PAR	EXEC		0
REM_HIDDEN			0
